NO ./path_to_the_north_texture
SO ./path_to_the_south_texture
WE ./path_to_the_west_texture
EA ./path_to_the_east_texture

F 220,100,0
C 225,30,0

        1111111111111111111111111
        1000000000110000010000001
        1011001001110001000010001
        1001001000000000001000011
111111111011000001110001000001001
100000000011000001110111111111111
11110111111111011100000010001
11110111111111011101010010001
11000000110101011100000010001
10001010100000001100000010001
10000000000101001101010010001
11000001110101011111011110N0111
11110111 1110101 101111010001
11111111 1111111 111111111111