
NO textures/Tiles.png

SO textures/bluestone.png

WE textures/green.png

EA textures/black.png

F 189,160,69
C 128,128,223



        1111111111111111111111111
        1000000000110000010000001
        1011001001110001000010001
        1001001000000000001000011
111111111011000001110001000001001
100000000000000001000100011111111
11000011111111011100000010001
11000111111111000001010010001
11010000110101011100000010001
1000101010000000000010S010001
10000000000101001101010010001
1100000111010101111101111000111
11110111 1110101 101111010001
11111111 1111111 111111011111